NO ./textures/N.xpm
C 10,42,150
D /home/daleliev/sgoinfre/cub3d/FINAL/textures/door_closed.xpm
           SO          ./textures/S.xpm
WE ./textures/W.xpm                   
EA ./textures/E.xpm                          
F 42   ,       42       ,            42     

   1   111111111111111111111111
       10020000001100000000000011                  1
 1      1011000001110000000000001                 101
       10010000E0202000000000001                   101                
111111111011000001110000000000001                   1  
110000010011111111112111111111111
1111011 111     10000001000111111
111101  1111111 101010010001 
11001 1 101     1100012100011111111         
1001    111 11111100020010001
1000111 111 11111101010010001
1111111 111     111111011111
1111111111111111011111111111
11000010111    1011111001111
1111011111111111111 111000001
1111111111111111111 11 11111
