NO ./textures/tex_n.xpm
C 25,30,0

SO ./textures/tex_s.xpm
WE ./textures/tex_w.xpm
		EA ./textures/tex_e.xpm
   F  25,5,25
11111111111111111
10000010000001001
10111000000000001
10001100011000001
1000000000000E001
10001101000011001
10001100000000001
11111111111111111
